w-----wwwwwww
wp-----*----w
wwww--------w
w-----------w
w-----------w
w-----**----w
w-----------w
w-----------w
w-----------w
w******--***w
w-----------w
w&--------**w
wwwwwwwwwwwww