wwwwwwwwwwwww
w-----p-*---w
w-----------w
w-----*---www
w-----------w
wwwww-------w
w*****---***w
w-----------w
w-----------w
w***---*****w
w-----------w
w----------&w
wwwwwwwwwwwww