wwwwwwwwwwwww
w---*------pw
w--*--------w
w---------www
w----wwww*www
w---*wwwwwwww
w-----------w
w&---------*w
wwwwwwwwwwwww
